WWWWWWWWWWWWWWWWWWWWWWWWWWWWWWWWWWWWWWWWWWWWWWWWWWWWWW
W00000000W0000000000000000000000000000000000000000000W
W00000000W0000000000000000000000000000000000000000000W
W00000000W0000000000000000000000000000000000000000000W
W00000000W0000000000000000000000000000000000000000000W
WWWWWWWDWW0000000000000000000000000000000000000000000W
W0000000000000000000000000000000000000000000000000000W
W0000P00000000000000000000000000000000000000000000000W
W0000000000000000000000000000000000000000000000000000W
W0000000000000000000000000000000000000000000000000000W
W0000000000000000000000000000000000000000000000000000W
W0000000000000000000000000000000000000000000000000000W
W0000000000000000000000000000000000000000000000000000W
W0000000000000000000000000000000000000000000000000000W
W0000000000000000000000000000000000000000000000000000W
W0000000000000000000000000000000000000000000000000000W
W0000000000000000000000000000000000000000000000000000W
W0000000000000000000000000000000000000000000000000000W
W0000000000000000000000000000000000000000000000000000W
W0000000000000000000000000000000000000000000000000000W
W0000000000000000000000000000000000000000000000000000W
W0000000000000000000000000000000000000000000000000000W
W0000000000000000000000000000000000000000000000000000W
WWWWWWWWWWWWWWWWWWWWWWWWWWWWWWWWWWWWWWWWWWWWWWWWWWWWWW